MMMMMMMMMMMMMMMMMMMM
MCCCCCCCCACCCCCCCCCM
MCCCCCCCCCCCCCCCCCCM
MCCBCCCCCCCCCCCBCCCM
MCCCCCCCCCCCCCCCCCCM
MCCCCCCCCCCCCCCCCCCM
MCCCCCCCCCCCCCCCCCCM
MCCCCCCCCCCCCCCCCCCM
MCCCCCCCCCCCCCCCCCCM
MCCCCCCCCCCCCCCCCCCM
MCCCCCCCCCCCCCCCCCCM
MCCCCCCCCCCCCCCCCCCM
MCCCCCCCCCCCCCCCCCCM
MCCCCCCCCCCCCCCCCCCM
MCCCCCCCCCCCCCCCCCCM
MMMCMMMMMMMMMMMMCCCM
MCCLCCCCCCCCCCCMCCCM
MCCCCCCCCCCCLCCMCCCM
MCCCCCCCCCCCCCCMCCCM
MMMMMMMMMMMMMMMMMMMM
