MMMMMMMMMMMMMMMMMMMM
MMCCCCMCCCCCCLCCCCCM
MCMCLCMCCCCBCCCCCLCM
MCCMCCMCCLCCCCCMCCCM
MCLCBCMCCCCMCCCMCCCM
MCCCCCCCCCCMMMMMCMCM
MMBCCCBCCCCCCCCCCLCM
MCCCCCCCCCCCCCCCCCCM
MCCCCCCCCCCMMMCCCCCM
MCCMCCCCCCCBCMCCCCCM
MCCMCCCCCCCCCMCCCMMM
MCCMCCCCCCCCCMCCCCCM
MCCMMMMCCCCCCMCCCCCM
MCCCCCCCLCCCCBCCCCCM
MCCCCCCCCCCCCCCCCCCM
MCBCCMMMMMCCCCCCCBCM
MCCCCMCCACCCCCCCCCCM
MCCCCMCCCMCLCCCCCCCM
MCCCCMCCCMCMCCCCCCCM
MMMMMMMMMMMMMMMMMMMM
