MMMMMMMMMMMMMMMMMMMM
MCCCCCCCCCCCCCCCCCCM
MCCCCCCCCCCCMMMMMMMM
MCCCCCCCCCCCMCCCLCCM
MCCCCCCCCCCCMCCCCCCM
MCCCCCBCCCCCMCCCCCCM
MCCCCCCCCCCCMCCCCCCM
MCCCCCCCCCCCCCCCCCCM
MCCCCCCCCCCCCCCCCCCM
MCCCCCCCCCCCCCCCCCCM
MCCCCCCCCCCCCCCCCCCM
MCCCCCCCCCCCCCCCCCCM
MCMMMMMCCCCCCCCCCCCM
MCCCCCMCCCCCCCCCCCCM
MCCCCCMCCCCCCCCCCCCM
MCCMCCMCCCCCCCCCCCCM
MCCCCCMCCCCCCCCCCCCM
MCCCCCCCCCCCCCCCCCAM
MCCCCCCCCCCCCCCCCCCM
MMMMMMMMMMMMMMMMMMMM
