MMMMMMMMMMMMMMMMMMMM
CCCCCCCCCCCMMCCCCCCC
CCCCCCCCCCMCCMCCCCCC
CCCCCCCCCMCCCCMCCCCC
CCCCCCCCCCCCCCCMCCCC
CCCCCCMMMMMCCCCCCCCC
CCCCCCMCCCMCCCCCACCC
CCCCCCMCCCMCCCCCCCCC
CCCCCCMMMMMCCCCCCCCC
CCCCCCMCCCMCCCCCCCCC
CCCCCCMCCCMCCCCCCCCC
CCCCCCMCCCMCCCCCCCCC
CCCCCCMCCCMCCCCCCCCC
CCCMMMMCCCMMMMCCCCCC
CCCMCCCCMCCCCMCCCCCC
CCCMCCCCMCCCCMCCCCCC
CCCMCCCCMCCCCMCCCCBC
CCCMCCCCMCCCCMCCCCCC
CCCCCCCCCCCCCCCLCCCC
CCCCCCCCCCCCCCCCCCCC
