MMCCMCMCCMMCMCMCCMMM
CCCCCCCCCCCCCCCCCCCC
MCCCCCCCCCCCCCCCCCCM
CCCCCCMCCCCCCCCCCCCM
MCCCCCCCCCCCCCCCCCCC
CCCCCCCCCCCCCCCCCCCM
CCCCCCCCCCCCCCCCCCCM
CCCCCCCCCCCCCCMCCCCM
CCCCCACCCCCBCCCCCCCM
CCCCCCCCCCCCCCCCCCCC
CCCCCCCCCCCCCCCCCCCM
MCCCCCCCCCCCCCCCCCCM
CCCCCCCCCCCCLCCMCCCC
CCCCCCCMCCCCCCCCCCCM
MCCCCCCCCCCCCCCCCCCC
CCCCCCCCCCCCCCCCCCCC
CCCCCCCCCCCCCCCCCCCC
MCCCCCCCCCCCCCCCCCCM
MCCCCCCCCCCCCCCCCCCC
CCCMCMCCCMCCMMCMMCMM
