MCCCCCCCCCCCCCCCCCCC
CCCCCCCMCCCCCCMCCMCC
CBCCCCCCCCCCMCCCCCCC
CCCCCCCCCMCCCCCCCCMC
CCCCCCCCCCCCCCCCCCCC
CCCCCCMCCCMCCCCCCCCC
CCCCCCCCCCCCCCCCCCCC
CCCCCCCCCCCCCMCCCMCC
CCMCCCBCCCCCCCCMCCCC
CCCCCCCCCCCCCCCCMCCC
CCCCCCCCCCMCCCCCCMCC
CCCCCCCCCCCCCCCCCCCC
CCMCCCBCCCCCMCCCCCCC
CCCCCCCCCCCCCCCCMCCC
CCCCCCCCBCMCCCCCCCCC
CCCCCCCCCCCCCCCCCCCC
CCCCCCMCCCCCCMCCCCCC
CCCCCCCCCCCCCCCCCCCC
CCCCCCCCCCCCCCCCCCCC
CCCCCCCCCCCCCCCCCCCC
