MMMMMMMMMMMMMMMMMMMM
MCMMMCCCCCCCCCCCCCCM
MCCMCCCLCCCCCCCCCCCM
MCCMCCCCCCCCCCCCCCCM
MCMMCCCCCCCCCCCCLCCM
MCMCCCCCCCCCCCCCCCCM
MCCCCCCCCCCCCCCCCCCM
MCCCCCCCCCCCCCCCCCCM
MCCCCCCCCCCCCCCCCCCM
MCCCCLCCCCCCCCCCCCCM
MCCCCCCCCCCCCCCCCCCM
MCCCCCCCCCMCCCCCCCCM
MCCCCCCCCCMCCCCCCCCM
MCCBCCCCCCMCCCCCCCCM
MCCCCCCCCCMCCCCCCCCM
MCCCMMMMMCMCCCCCBCCM
MCCCMCCCCCMCCCCCCCCM
MCCCMCCCCCMCCCCBCCCM
MCCCMCACCCMCCCCCCCCM
MMMMMMMMMMMMMMMMMMMM
