MMMMMMMMMMMMMMMMMMMM
MCCCCCMMMMMCCCCCCCCM
MCCCCCCCCCMCCCCCCCCM
MCCCCCMCCCMMCCCCCCCM
MCCCLCMCCCCCCCLCCCCM
MCCCCCMCCCCCCCCCCCCM
MCCCCCMMMMMMCCCCCCCM
MCCCCCMCCCCCCCCCCCCM
MCCCCCMMMMMMCMMMMMMM
MCCCCCMCCCCBLCCCCCCM
MCCCCCMCCCCCCCCCCCCM
MMMMMMMCCCCCCCCCCCCM
MCCCCCCCCCCCCCCCCCCM
MCCCCCCCCCCCMMMMMCMM
MCCCCCCACCCCCCBCCCCM
MCCCBCCCCCBCMMMMMCMM
MCCCCCCCCCCCCCCCCCCM
MCCCCCCCLCCCCCCCCCCM
MCCCCCCCCCCCCCCCCCCM
MMMMMMMMMMMMMMMMMMMM
