MCCACCCCCCCCCCCCCCCM
MCCCCCCCCCCCCCCCCCCM
MCCCCCCCCCCCCCCCCCCM
MCCCCCCCCCCCCCCCCCCM
MCCCCCCCCCCCCCCCCCCM
MCCCCCCCCCCCCCCCCCCM
MCCCCCCCCCCCCCCCCCCM
MCCCCCCCCCCCCCCCCCCM
MCCCCCCCCCCCCCCCCCCM
MCCCCCCCCCCCBLCCCCCM
MCCCCCCCCCCCCCCCCCCM
MCCCCCCCCCCCCCCCCCCM
MCCCCCCCCCCCCCCCCCCM
MCCCCCCCCCCCCCCCCCCM
MCCCCCCCCCCCCCCCCCCM
MCCCCCCCBBBCCCCCCCCM
MCCCCCCCCCCCCCCCCCCM
MCCCCCCCCCCCCCCCCCCM
MCCCCCCCCCCCCCCCCCCM
MCCCCCCCCCCCCCCCCCCM
