MMMMMMMMMMMMMMMMMMMM
MMCCCCCCCCCCCCCCCCMM
MMCCCCCCCCCCCCCCCCMM
CCMCLCCCCLCCCCLCCCMC
CCCMCCCCCCCCCCCCCMCC
CCCCMCCCCCCCCCCCMCCC
CCCCCMCCCCCCCCCMCCCC
CCCCCCMCCCCCCCMCCCCC
CCCCCCCMMCCMMMCCCCCC
CCCCCCMCCCCCCCMCCCCC
CCCCCMCCCCCCCCCMCCCC
CCCCMCCCCCCCCCCCMCCC
CCCMCCBCCCCCCCBCCMCC
CCMCCCCCCCCCCCCCCCMC
CMCCCCCCCCCCCCCCCCCM
MCCACCCCCCBCCCCCCCMC
CMCCCCCCCCCCCCCCCMCC
CCMCCCCCCCCCCCCCMCCC
CCCMCCCCCCCCCCCMCCCC
CCCCMCCCCCCCCCMCCCCC
