MMMMMMMMMMMMMMMMMMMM
CCCCCCCCCCCCCCCCCCCM
CCCCCCCCCCCCCCCCCCCM
CCCMCCCCCCCCCCCCCCCM
CCCCCCCCCCLCCCCCCCCM
CCCCCCCCCCCCCCCCCCCM
CCCCCCBCCCCCCCCCCCCM
CCCCCCCCCCCCCCCCCCCM
CCCCCCCCCCCCCCCCCCCM
CCCCCCCCCCCCCCCCCCCM
CCCCCCCCCCCACCCCCCCM
CCCCCCCCCCCCCCCCCCCM
CCCCCCCCCCCCCCCCCCCM
CCCCCCCCCCCCCCCCCCCM
CCCCCCCCCCCCCCCCCCCM
CCCCCCCCCCCCCCCCCCCM
CCCCCCCCCCCCCCCCCCCM
CCCCCCCCCCCCCCCCCCCM
CCCCCCCCCCCCCCCCCCCM
MMCMCCCCCCCCCCCCCCCM
